SARS-CoV-2_1_LEFT	AACAAACCAACCAACTTTCGATCTC	CTTCTACTAAGCCACAAGTGCCA
SARS-CoV-2_2_LEFT	TTTACAGGTTCGCGACGTGC	ATAAGGATCAGTGCCAAGCTCG
SARS-CoV-2_3_LEFT	GTAATAAAGGAGCTGGTGGCCA	GCCAATTTAATTTCAAAAGGTGTCTGC
SARS-CoV-2_4_LEFT	GTGTATACTGCTGCCGTGAACA	ACAACAGCATTTTGGGGTAAGTAAC
SARS-CoV-2_5_LEFT	TGAAACTTCATGGCAGACGGG	TTGATGTTGACTTTCTCTTTTTGGAGT
SARS-CoV-2_6_LEFT	CGTGCTAGCGCTAACATAGGTT	AACACGCACAGAATTTTGAGCAG
SARS-CoV-2_7_LEFT	ACTGAGTCCTCTTTATGCATTTGC	CCACCGACAATTTCACAAGCAC
SARS-CoV-2_8_LEFT	GCTTGAAGAGAAGTTTAAGGAAGGTG	GGTTGTTCTAATGGTTGTAAATCACCA
SARS-CoV-2_9_LEFT	TCTTCTTAGAGGGAGAAACACTTCC	CACAGGCGAACTCATTTACTTCTG
SARS-CoV-2_10_LEFT_alt1	TGAATATCACTTTTGAACTTGATGAAAGGATTG	GGTTGAAGAGCAGCAGAAGTG
SARS-CoV-2_10_LEFT	TGAGAAGTGCTCTGCCTATACAGT	TCATCTAACCAATCTTCTTCTTGCTCT
SARS-CoV-2_10_LEFT_alt1	TGAATATCACTTTTGAACTTGATGAAAGGATTG	TCATCTAACCAATCTTCTTCTTGCTCT
SARS-CoV-2_10_LEFT	TGAGAAGTGCTCTGCCTATACAGT	GGTTGAAGAGCAGCAGAAGTG
SARS-CoV-2_11_LEFT	AGAAGAGTTTGAGCCATCAACTCA	TTTAAGGCTCCTGCAACACCTC
SARS-CoV-2_12_LEFT	TGCAGACATTGTGGAAGAAGCT	CAGCTAAGTAGACATTTGTGCGAAC
SARS-CoV-2_13_LEFT	AGCACGAAGTTCTACTTGCACC	GATGTCAATGTCACTAACAAGAGTGG
SARS-CoV-2_14_LEFT	TGGAAGAAACTAAGTTCCTCACAGAA	CATGTGCAAGCATTTCTCGCAA
SARS-CoV-2_15_LEFT	AAAAGTGCCTTTTACATTCTACCATCT	GCATCAGGTGAAGAAACAGAAACTG
SARS-CoV-2_16_LEFT	TGTAACACATGGCTTAAATTTGGAAGAA	CACAACTTGCGTGTGGAGGTTA
SARS-CoV-2_17_LEFT	TGACAATCTTAAGACACTTCTTTCTTTGAG	TTCAACTCTATTTGTTGGAGTGTTAACAA
SARS-CoV-2_18_LEFT	TGGAAATACCCACAAGTTAATGGTTTAAC	GCTTGTTTACCACACGTACAAGG
SARS-CoV-2_19_LEFT	AAGCTGTTATGTACATGGGCACA	TGTCCAACTTAGGGTCAATTTCTGT
SARS-CoV-2_20_LEFT	ACAAAGAAAACAGTTACACAACAACCA	ACGTGGCTTTATTAGTTGCATTGTT
SARS-CoV-2_21_LEFT	CACTACACACCCTCTTTTAAGAAAGG	GTAAGACTAGAATTGTCTACATAAGCAGC
SARS-CoV-2_22_LEFT	GTAGGAGACATTATACTTAAACCAGCAAA	CCGACACTCTTAACAGTATTCTTTGC
SARS-CoV-2_23_LEFT	AAACCGTGTTTGTACTAATTATATGCCTT	AACCACTAAGACAAACACTACAAGGT
SARS-CoV-2_23_LEFT	AAACCGTGTTTGTACTAATTATATGCCTT	AGAATCTAAACCACTAAGACAAACACTAC
SARS-CoV-2_24_LEFT	GGTTACAGAGAAGGCTATTTGAACTCT	ACAACATGCACATAACTTTTCCATACA
SARS-CoV-2_25_LEFT	CAAATGGCCCCGATTTCAGCTA	TGGATGGAACCATTCTTCACTGT
SARS-CoV-2_26_LEFT	GCGAGAGACTTGTCACTACAGTT	GAGTTTTTCCATTGGTACGTTAAAAGTTG
SARS-CoV-2_27_LEFT	CTGATGTTGGTGATAGTGCGGA	AATGTTGTGACTTTTTGCTACCTGC
SARS-CoV-2_27_LEFT	CTGATGTTGGTGATAGTGCGGA	AGCAATGTTGTGACTTTTTGCTACC
SARS-CoV-2_28_LEFT	TGAAAACATGACACCCCGTGAC	TGACACCACCATCAATAGCCTTG
SARS-CoV-2_29_LEFT	CTTGTGTTCCTTTTTGTTGCTGC	AGCCAAAACACAAGCTGATGTTG
SARS-CoV-2_30_LEFT	ACCTAGAGTTTTTAGTGCAGTTGGT	CTACACCACAGAAAACTCCTGGT
SARS-CoV-2_31_LEFT	CCTTGAAGGTTCTGTTAGAGTGGT	AATGAGTAAACTGGTGTTAAACAGAGTAC
SARS-CoV-2_32_LEFT	GAGCTTTTGGTGAATACAGTCATGTAG	GAGGTAATAGCACATCACTACGCA
SARS-CoV-2_33_LEFT	GTACTTTTGAAGAAGCTGCGCTG	TGTCTTGGACAGTAAACTACGTCATC
SARS-CoV-2_34_LEFT	TCCCATCTGGTAAAGTTGAGGGT	CCACATGAACCATTAAGGAATGAACC
SARS-CoV-2_35_LEFT	GTGTTAGCTTGTTACAATGGTTCACC	AGGTCCTAGTATGTCAACATGGTCT
SARS-CoV-2_36_LEFT	CAATCGATTTACCACAACTCTTAATGACT	ACCCATAGCAAAAGGTAAAAAGGC
SARS-CoV-2_37_LEFT	CACACCACTGGTTGTTACTCACA	GTGTCAAGACATTCATAAGTGTCCAC
SARS-CoV-2_38_LEFT	GACTGTGTTATGTATGCATCAGCTG	CCTGTGTAGAAACTAAGTAATCATAAACACC
SARS-CoV-2_39_LEFT	GCTATTTTTGTACTTGTTACTTTGGCC	CCCTGCATGGAAAGCAAAACAG
SARS-CoV-2_40_LEFT	TGTCCAGTTACACAATGACATTCTCT	ACTTTTGCCCTCTTGTCCTCAG
SARS-CoV-2_41_LEFT	ATTTGACCGTGATGCAGCCAT	AAGAGGCCATGCTAAATTAGGTGAA
SARS-CoV-2_42_LEFT	TGGTACAACATTTACTTATGCATCAGC	TGTCTGTAACAAACCTACAAGGTGG
SARS-CoV-2_43_LEFT	GGATTTGAAATGGGCTAGATTCCCT	CGATGCACCACCAAAGGATTCT
SARS-CoV-2_44_LEFT	GGGGACAACCAATCACTAATTGTG	CATCAGTACTAGTGCCTGTGCC
SARS-CoV-2_45_LEFT	TAAACGGGTTTGCGGTGTAAGT	TCACAATTACCTTCATCAAAATGCCT
SARS-CoV-2_46_LEFT	AGAATAGACGGTGACATGGTACC	TCTACAACAGGAACTCCACTACCT
SARS-CoV-2_47_LEFT	TGGTGTACTGACATTAGATAATCAAGATCT	TGGAACACCATCAACAAATATTTTTCTCA
SARS-CoV-2_48_LEFT	ACTGTTTGGATGACAGATGCATTC	CAGAACTTCCTTCCTTAAAGAAACCC
SARS-CoV-2_49_LEFT	ACAATGTTGCTTTTCAAACTGTCAAAC	GGGATGACATTACGTTTTGTATATGCG
SARS-CoV-2_50_LEFT	CATTTAATAAATGGGGTAAGGCTAGACTTT	GAGCAAGAACAAGTGAGGCCAT
SARS-CoV-2_51_LEFT	GCAAATTCTATGGTGGTTGGCAC	GTCTGTGTTGTAAATTGCGGACA
SARS-CoV-2_52_LEFT	CTGTCACGGCCAATGTTAATGC	GGATCTGGGTAAGGAAGGTACACA
SARS-CoV-2_53_LEFT	ACTAAAGGACCTCATGAATTTTGCTC	GCAAAGAACACAAGCCCCAAC
SARS-CoV-2_54_LEFT	ACATGATGAGTTAACAGGACACATG	CCAAAAACTTGTCCATTAGCACACA
SARS-CoV-2_55_LEFT	AATGCTCCAGGTTGTGATGTCA	ACACGATAACCAGTAAAGACATAATTTCG
SARS-CoV-2_56_LEFT	ACTGTACGTGAAGTGCTGTCTG	TGACTCTTACCAGTACCAGGTGG
SARS-CoV-2_57_LEFT	GGCTTATACCCAACACTCAATATCTCA	CTGGCATTGACAACACTCAAATCA
SARS-CoV-2_58_LEFT	TGCCTGAGACGACAGCAGATAT	TGTGGCCTGTTAATTGCAGATGA
SARS-CoV-2_59_LEFT	GCTTAAAGCACATAAAGACAAATCAGC	TCCTACGTGGAATTTCAAGACTTGT
SARS-CoV-2_60_LEFT	ACAGATTTAATGTTGCTATTACCAGAGC	TAGCATGACACCCCTCGACAT
SARS-CoV-2_61_LEFT	ACCCTAACATGTTTATCACCCGC	GCTCAGGTCCTATTTTCACAAAATACTT
SARS-CoV-2_62_LEFT	GTGACACACTTAAAAATCTCTCTGACAG	CCGCATTAATCTTCAGTTCATCACC
SARS-CoV-2_63_LEFT	TAGGTGTCTAGCTGTCCACGAG	CCAGGCAAGTTAAGGTTAGATAGCA
SARS-CoV-2_64_LEFT	GCCTATTTTGGAATTGCAATGTCGA	GTATCAAATTGTTTGTAAACCCACAAGC
SARS-CoV-2_65_LEFT	GTCTGTAGACATCATGCTAATGAGTACA	GCTGGAGCATCTCTTTTGTAGTCC
SARS-CoV-2_66_LEFT	AACCAGTACCAGAGGTGAAAATACTC	TTTCTACTCTGAGTAAAGTAAGTTTCAGGT
SARS-CoV-2_67_LEFT	CAAACAAGCTAGTCTTAATGGAGTCAC	AACACACACACTTAGATGAACCTGT
SARS-CoV-2_68_LEFT	GACTAGCTAAACGTTTTAAGGAATCACC	GCGACATTCATCATTATGCCTTTAGG
SARS-CoV-2_69_LEFT	CGGGTGTTGCTATGCCTAATCT	TTTGTAACATTTTTAGTCTTAGGGTCGTAC
SARS-CoV-2_70_LEFT	TTGATTGGTGATTGTGCAACTGTAC	AGAATAGGAAGACAACTGAATTGGATTTG
SARS-CoV-2_71_LEFT	GGCAAACCACGCGAACAAATAG	TGAGGATCTGAAAACTTTGTCAGGG
SARS-CoV-2_72_LEFT	GTGATGTTCTTGTTAACAACTAAACGAAC	GTAGCGTTATTAACAATAAGTAGGGACTG
SARS-CoV-2_73_LEFT	AGAGGCTGGATTTTTGGTACTACT	ACCTAGTGATGTTAATACCTATTGGCA
SARS-CoV-2_74_LEFT	TGGACCTTGAAGGAAAACAGGG	TGATAGATTCCTTTTTCTACAGTGAAGGA
SARS-CoV-2_75_LEFT	GAAAATGGAACCATTACAGATGCTGT	TTTGCCCTGGAGCGATTTGT
SARS-CoV-2_76_LEFT	GCTGATTATTCTGTCCTATATAATTCCGC	GTTGGAAACCATATGATTGTAAAGGAAAG
SARS-CoV-2_76_LEFT_alt1	ATGTCTATGCAGATTCATTTGTAATTAGAGGT	GTCCACAAACAGTTGCTGGTG
SARS-CoV-2_76_LEFT	GCTGATTATTCTGTCCTATATAATTCCGC	GTCCACAAACAGTTGCTGGTG
SARS-CoV-2_76_LEFT_alt1	ATGTCTATGCAGATTCATTTGTAATTAGAGGT	GTTGGAAACCATATGATTGTAAAGGAAAG
SARS-CoV-2_77_LEFT	CAAACCTTTTGAGAGAGATATTTCAACTGA	CACTGACACCACCAAAAGAACATG
SARS-CoV-2_78_LEFT	CTGAGTCTAACAAAAAGTTTCTGCCTT	GGATTGACTAGCTACACTACGTGC
SARS-CoV-2_79_LEFT	ACCCATTGGTGCAGGTATATGC	AATTGGTGGTGTTTTGTAAATTTGTTTGAC
SARS-CoV-2_79_LEFT	ACCCATTGGTGCAGGTATATGC	CCAAAATCTTTAATTGGTGGTGTTTTGT
SARS-CoV-2_80_LEFT	CCGTGCTTTAACTGGAATAGCTG	GCAAATGGTATTTGTAATGCAGCAC
SARS-CoV-2_81_LEFT	TGCTCAATACACTTCTGCACTGT	TGAAGTCTGCCTGTGATCAACC
SARS-CoV-2_82_LEFT	TGCACAAGCTTTAAACACGCTT	CACGAGGAAAGTGTGCTTTTCC
SARS-CoV-2_83_LEFT	GCATGTGACTTATGTCCCTGCA	AGATTCATTTAAATTCTTGGCAACCTCA
SARS-CoV-2_84_LEFT	GTTGATTTAGGTGACATCTCTGGCA	AGCATCCTTGATTTCACCTTGCT
SARS-CoV-2_85_LEFT	ATGAAGACGACTCTGAGCCAGT	CTGCAAGAAGTAGACTAAAGCATAAAGAT
SARS-CoV-2_86_LEFT	TGTTGTTTGTAACAGTTTACTCACACC	TCAATTGAGTTGAGTACAGCTGGT
SARS-CoV-2_87_LEFT	GTGGTTATACTGAAAAATGGGAATCTGG	AATCGAAGCGCAGTAAGGATGG
SARS-CoV-2_88_LEFT_alt1	TTATGTACTCATTCGTTTCGGAAGAG	ACAAAAACCTATTCCTGTTGGCATAG
SARS-CoV-2_88_LEFT	CGTTTCGGAAGAGACAGGTACG	ACAAAAACCTATTCCTGTTGGCATAG
SARS-CoV-2_89_LEFT	AAGCTCCTTGAACAATGGAACCT	CAGCAATACGAAGATGTCCACGA
SARS-CoV-2_89_LEFT_alt1	TAGGTTTCCTATTCCTTACATGGATTTGT	CTAGATGGTGTCCAGCAATACGAAG
SARS-CoV-2_89_LEFT	AAGCTCCTTGAACAATGGAACCT	CTAGATGGTGTCCAGCAATACGAAG
SARS-CoV-2_89_LEFT_alt1	TAGGTTTCCTATTCCTTACATGGATTTGT	CAGCAATACGAAGATGTCCACGA
SARS-CoV-2_90_LEFT	ATTCTTCTCAACGTGCCACTCC	ATTAGTAATATCTCTGCTATAGTAACCTGAAAG
SARS-CoV-2_90_LEFT	ATTCTTCTCAACGTGCCACTCC	TCCAAATGGAAACTTTAAAAGTCCTCA
SARS-CoV-2_91_LEFT	TCCAGTAGCAGTGACAATATTGCTT	AGTGCAAATTTGTTATCAGCTAGAGG
SARS-CoV-2_92_LEFT	CACTACCAAGAGTGTGTTAGAGGTAC	GTTCAAGTGAGAACCAAAAGATAATAAGC
SARS-CoV-2_93_LEFT	TTGTTGCGGCAATAGTGTTTATAACA	TGGGTGATTTAGAACCAGCCTC
SARS-CoV-2_94_LEFT	ACCCGTGTCCTATTCACTTCTATTC	TTATTGGGTAAACCTTGGGGCC
SARS-CoV-2_95_LEFT	GTGCGTTGTTCGTTCTATGAAGAC	ACCATCTTGGACTGAGATCTTTCATT
SARS-CoV-2_96_LEFT	AGATGACCAAATTGGCTACTACCG	CCATTGCCAGCCATTCTAGCA
SARS-CoV-2_97_LEFT	TTCCTCATCACGTAGTCGCAAC	CGACATTCCGAAGAACGCTGA
SARS-CoV-2_98_LEFT	CCAGGAACTAATCAGACAAGGAACT	TTTAGGCCTGAGTTGAGTCAGC
SARS-CoV-2_99_LEFT	CTTCTTCCTGCTGCAGATTTGGA	GCTATTAAAATCACATGGGGATAGCAC